1 1 1 1 1 1 1 1 1 1 1 1 1 1 1 1 1 1 1 1
1 0 0 0 0 0 20 0 0 0 0 0 0 0 20 20 20 20 20 1
1 0 0 0 0 0 20 0 0 0 0 0 0 0 20 20 20 20 20 1
1 0 0 0 0 0 0 0 0 0 0 0 0 0 0 0 0 20 20 1
1 0 0 0 0 0 0 0 0 0 0 0 0 0 0 0 0 20 20 1
1 0 0 0 0 0 0 0 0 0 0 0 0 0 0 0 0 0 0 1
1 0 0 0 20 20 20 20 20 0 0 0 0 0 0 0 0 0 0 1
3 0 0 0 20 20 20 20 20 0 0 0 0 0 0 0 0 0 0 2
1 0 0 0 20 20 20 20 20 0 0 0 0 0 0 0 0 0 0 1
1 0 0 0 1 1 1 1 1 1 1 1 1 1 1 1 0 0 0 1
1 0 0 0 0 0 0 0 0 0 0 0 0 0 0 0 0 0 0 1
1 0 0 0 0 0 0 0 0 0 0 0 0 0 0 0 0 0 0 1
1 0 0 0 0 0 0 0 0 0 0 0 0 0 0 0 0 0 0 1
1 0 0 0 0 0 0 0 0 0 0 0 0 0 0 0 0 0 0 1
1 0 0 0 1 1 1 1 1 1 1 1 1 1 1 1 0 0 0 1
1 1 1 1 1 1 1 1 1 1 1 1 1 1 1 1 1 1 1 1